11111111111
1P000000001
1000E00C001
11111111111