1111111111111111
1P000000000X0001
10000000C0000E01
1111111111111111